Name,Volume,Ask Size,Ask Price,Bid Size,Bid Price,Last Price,Shares Matched,Shares Routed
VXX,2758830,0,0.00,0,0.00,15.38,2705288,53542
VIXY,1277844,0,0.00,0,0.00,15.00,1275009,2835
USHY,1005495,0,0.00,0,0.00,35.73,1005295,200
NVDQ,932934,0,0.00,0,0.00,6.21,932831,103
UVIX,822416,0,0.00,0,0.00,11.83,811757,10659
UVXY,647303,0,0.00,0,0.00,40.50,640391,6912
BITX,602819,0,0.00,0,0.00,41.10,594781,8038
IEFA,570757,0,0.00,0,0.00,70.78,527877,42880
IGV,515435,0,0.00,0,0.00,78.53,514368,1067
FBTC,492090,0,0.00,0,0.00,56.20,466963,25127
AAAU,466169,0,0.00,0,0.00,23.64,462947,3222
INDA,436221,0,0.00,0,0.00,51.00,436221,0
ARKG,421142,0,0.00,0,0.00,23.32,412872,8270
GOVT,355299,0,0.00,0,0.00,22.25,355262,37
USMV,352522,0,0.00,0,0.00,80.50,347543,4979
ARKB,317387,0,0.00,0,0.00,64.25,316135,1252
VHAI,272150,0,0.00,0,0.00,0.23,255916,16234
COWZ,268464,0,0.00,0,0.00,55.16,268062,402
QUAL,248704,0,0.00,0,0.00,154.56,234641,14063
ITB,235520,0,0.00,0,0.00,102.36,234148,1372
MTUM,234069,0,0.00,0,0.00,173.58,223462,10607
EZU,218808,0,0.00,0,0.00,48.73,215284,3524
CBOE,216002,0,0.00,0,0.00,180.53,212918,3084
SVIX,204250,0,0.00,0,0.00,35.50,201114,3136
NOBL,189797,0,0.00,0,0.00,96.74,189069,728
EFV,188758,0,0.00,0,0.00,52.82,174186,14572
SVXY,179089,0,0.00,0,0.00,51.48,178663,426
PAVE,178479,0,0.00,0,0.00,37.29,172377,6102
NVDX,161486,0,0.00,0,0.00,68.55,159367,2119
EFAV,151441,0,0.00,0,0.00,68.25,143181,8260
MOAT,146052,0,0.00,0,0.00,84.30,143069,2983
CALF,138985,0,0.00,0,0.00,46.69,137905,1080
BBUS,112864,0,0.00,0,0.00,89.42,112764,100
BBJP,97934,0,0.00,0,0.00,54.68,97503,431
BBCA,94503,0,0.00,0,0.00,64.70,94502,1
SPYI,90659,0,0.00,0,0.00,48.09,88100,2559
BBEU,79071,0,0.00,0,0.00,57.15,79054,17
IYZ,78920,0,0.00,0,0.00,20.68,78701,219
VNM,78493,0,0.00,0,0.00,11.94,78147,346
HEFA,76761,0,0.00,0,0.00,33.84,76461,300
ICOW,70354,0,0.00,0,0.00,31.24,62554,7800
BBAX,69106,0,0.00,0,0.00,45.87,68876,230
BTCW,67770,0,0.00,0,0.00,68.04,67620,150
FBCG,62701,0,0.00,0,0.00,35.75,59613,3088
ESGV,62379,0,0.00,0,0.00,87.24,62379,0
ITA,54984,0,0.00,0,0.00,129.39,54854,130
DFIC,52579,0,0.00,0,0.00,25.76,52579,0
OSCV,52479,0,0.00,0,0.00,34.08,52479,0
EEMV,52339,0,0.00,0,0.00,55.27,51966,373
BUFR,45090,0,0.00,0,0.00,27.33,45090,0
GAPR,44744,0,0.00,0,0.00,33.83,44744,0
ICF,44529,0,0.00,0,0.00,52.98,44352,177
BBHY,42945,0,0.00,0,0.00,45.14,37145,5800
PSFF,42770,0,0.00,0,0.00,26.43,42770,0
CNYA,38909,0,0.00,0,0.00,26.19,38909,0
IAGG,38849,0,0.00,0,0.00,49.51,38207,642
ICSH,38233,0,0.00,0,0.00,50.44,38233,0
LVHI,35844,0,0.00,0,0.00,29.29,30945,4899
FLHY,35799,0,0.00,0,0.00,23.25,35799,0
WTAI,34875,0,0.00,0,0.00,18.47,34875,0
FLOT,34711,0,0.00,0,0.00,51.02,34711,0
IDV,33886,0,0.00,0,0.00,27.16,32374,1512
FAPR,32902,0,0.00,0,0.00,36.58,32802,100
IYT,32858,0,0.00,0,0.00,65.86,32857,1
EZBC,30883,0,0.00,0,0.00,37.33,30883,0
HODL,30848,0,0.00,0,0.00,72.37,27598,3250
SING,29792,0,0.00,0,0.00,0.17,29792,0
VLUE,28697,0,0.00,0,0.00,101.24,26907,1790
HYD,27498,0,0.00,0,0.00,51.45,27498,0
GCOW,27335,0,0.00,0,0.00,33.97,26767,568
SLVP,27205,0,0.00,0,0.00,11.77,27205,0
ACWV,25276,0,0.00,0,0.00,101.95,25276,0
BOXX,25212,0,0.00,0,0.00,106.74,25212,0
BTCO,24920,0,0.00,0,0.00,64.25,24287,633
OMFL,24908,0,0.00,0,0.00,51.60,24546,362
PTLC,24568,0,0.00,0,0.00,45.19,24568,0
NEAR,23724,0,0.00,0,0.00,50.00,23724,0
IEO,23684,0,0.00,0,0.00,106.61,23284,400
REM,23574,0,0.00,0,0.00,21.79,23008,566
ECH,23572,0,0.00,0,0.00,26.25,23231,341
FLDR,22427,0,0.00,0,0.00,49.92,22427,0
MFUL,21862,0,0.00,0,0.00,20.92,21862,0
EFG,21437,0,0.00,0,0.00,97.17,21437,0
NFLP,20546,0,0.00,0,0.00,29.50,20546,0
IBHE,20281,0,0.00,0,0.00,23.24,16242,4039
RDVI,18997,0,0.00,0,0.00,23.35,18997,0
JCPB,18023,0,0.00,0,0.00,45.43,17918,105
VUSB,17994,0,0.00,0,0.00,49.38,17994,0
KNG,17979,0,0.00,0,0.00,51.73,17979,0
ARKQ,17112,0,0.00,0,0.00,49.86,17112,0
ICVT,16742,0,0.00,0,0.00,76.13,16662,80
SMDV,16609,0,0.00,0,0.00,60.90,16609,0
JMST,16386,0,0.00,0,0.00,50.66,16386,0
UAPR,16314,0,0.00,0,0.00,27.28,16214,100
PMAR,14083,0,0.00,0,0.00,35.78,13802,281
JMUB,13909,0,0.00,0,0.00,50.24,13909,0
ESML,13459,0,0.00,0,0.00,37.14,11453,2006
DISV,13431,0,0.00,0,0.00,26.49,11739,1692
FFLC,12989,0,0.00,0,0.00,39.71,12989,0
PAPR,12677,0,0.00,0,0.00,32.62,12677,0
MARM,12592,0,0.00,0,0.00,28.76,12592,0
ACIO,12377,0,0.00,0,0.00,34.75,12377,0
PICK,12367,0,0.00,0,0.00,42.78,12050,317
IGEB,12194,0,0.00,0,0.00,43.52,12194,0
IGE,11675,0,0.00,0,0.00,45.03,11575,100
BUYW,11372,0,0.00,0,0.00,13.48,11372,0
IQDG,10948,0,0.00,0,0.00,35.74,8648,2300
EYLD,10820,0,0.00,0,0.00,33.56,10820,0
ITM,10809,0,0.00,0,0.00,45.96,10545,264
MLN,10577,0,0.00,0,0.00,17.73,10577,0
QMAR,10504,0,0.00,0,0.00,25.43,10504,0
FFLG,10442,0,0.00,0,0.00,20.34,9757,685
EMHY,10437,0,0.00,0,0.00,36.77,10437,0
DFIS,10392,0,0.00,0,0.00,24.08,10292,100
TLTW,10327,0,0.00,0,0.00,25.07,10323,4
ICLO,10316,0,0.00,0,0.00,25.73,10316,0
OUSM,10168,0,0.00,0,0.00,39.49,10167,1
ARKX,9910,0,0.00,0,0.00,14.11,8209,1701
FLBL,9871,0,0.00,0,0.00,24.33,9771,100
BUFF,9804,0,0.00,0,0.00,41.01,9004,800
JBBB,9443,0,0.00,0,0.00,48.89,9443,0
DFNL,9365,0,0.00,0,0.00,32.06,9365,0
SMMV,9347,0,0.00,0,0.00,35.86,9347,0
IBMR,9079,0,0.00,0,0.00,24.92,9079,0
FMAG,8074,0,0.00,0,0.00,26.51,7874,200
FLQL,7972,0,0.00,0,0.00,49.92,7880,92
YBTC,7835,0,0.00,0,0.00,53.59,7835,0
TMFM,7712,0,0.00,0,0.00,24.93,7712,0
CEFS,7465,0,0.00,0,0.00,19.59,7465,0
STLG,7452,0,0.00,0,0.00,44.35,7452,0
GSST,7405,0,0.00,0,0.00,50.22,7405,0
RULE,7275,0,0.00,0,0.00,20.92,7275,0
NUMG,7224,0,0.00,0,0.00,40.60,7224,0
BALT,7203,0,0.00,0,0.00,28.98,7193,10
NUSC,7180,0,0.00,0,0.00,38.32,7180,0
SMIN,7114,0,0.00,0,0.00,72.79,7114,0
NULV,7084,0,0.00,0,0.00,36.90,7084,0
CEMB,6874,0,0.00,0,0.00,43.76,6774,100
XSHD,6838,0,0.00,0,0.00,14.64,6824,14
PTMC,6835,0,0.00,0,0.00,33.56,6835,0
VSGX,6825,0,0.00,0,0.00,54.67,6775,50
VOTE,6782,0,0.00,0,0.00,57.76,6782,0
IFRA,6778,0,0.00,0,0.00,41.75,6778,0
DRSK,6768,0,0.00,0,0.00,25.86,6768,0
NANC,6608,0,0.00,0,0.00,32.10,6608,0
GOVZ,6605,0,0.00,0,0.00,10.36,6605,0
FLQM,6505,0,0.00,0,0.00,49.93,6406,99
SYLD,6267,0,0.00,0,0.00,69.44,6267,0
HYDB,6096,0,0.00,0,0.00,45.75,6096,0
HYGW,6042,0,0.00,0,0.00,32.76,5617,425
NULG,5835,0,0.00,0,0.00,70.68,5835,0
SMMD,5798,0,0.00,0,0.00,60.39,5439,359
IYJ,5703,0,0.00,0,0.00,119.41,5703,0
IBMQ,5700,0,0.00,0,0.00,25.09,5700,0
VXZ,5666,0,0.00,0,0.00,14.36,5666,0
GMAR,5641,0,0.00,0,0.00,33.48,5641,0
EALT,5629,0,0.00,0,0.00,27.85,5629,0
CLSE,5582,0,0.00,0,0.00,19.83,5582,0
IBMM,5410,0,0.00,0,0.00,25.96,5410,0
SFEB,5349,0,0.00,0,0.00,19.42,4521,828
HEEM,5338,0,0.00,0,0.00,25.06,5338,0
DOCT,5300,0,0.00,0,0.00,37.20,5300,0
BUFD,5225,0,0.00,0,0.00,23.22,5225,0
QSPT,5200,0,0.00,0,0.00,24.16,5100,100
RSEE,5155,0,0.00,0,0.00,26.76,5155,0
QDEC,5152,0,0.00,0,0.00,23.92,5152,0
GOOX,5145,0,0.00,0,0.00,27.62,5140,5
PDEC,5129,0,0.00,0,0.00,35.89,5129,0
GVI,5118,0,0.00,0,0.00,102.34,5118,0
SECT,5067,0,0.00,0,0.00,47.41,4597,470
EMGF,4921,0,0.00,0,0.00,43.51,4921,0
MOTI,4889,0,0.00,0,0.00,30.01,4889,0
DDLS,4886,0,0.00,0,0.00,33.40,4686,200
JUCY,4861,0,0.00,0,0.00,23.32,4861,0
DIVB,4715,0,0.00,0,0.00,42.40,4715,0
XMAR,4681,0,0.00,0,0.00,32.94,4681,0
VFMO,4605,0,0.00,0,0.00,138.89,4605,0
TMFC,4558,0,0.00,0,0.00,46.69,4344,214
BUFQ,4538,0,0.00,0,0.00,27.24,4538,0
AAPR,4493,0,0.00,0,0.00,24.32,4493,0
TMFS,4460,0,0.00,0,0.00,28.97,4460,0
BAMD,4427,0,0.00,0,0.00,27.83,3827,600
VIXM,4330,0,0.00,0,0.00,16.55,4330,0
SDVD,4318,0,0.00,0,0.00,20.67,4318,0
DMAR,4266,0,0.00,0,0.00,33.84,4266,0
PJUN,4244,0,0.00,0,0.00,34.41,4244,0
ISDB,4200,0,0.00,0,0.00,24.70,4200,0
IEDI,4170,0,0.00,0,0.00,46.28,4170,0
IBHD,4109,0,0.00,0,0.00,23.25,4109,0
IDUB,4023,0,0.00,0,0.00,20.11,3923,100
UAUG,4010,0,0.00,0,0.00,31.71,4010,0
NUMV,3960,0,0.00,0,0.00,32.21,3387,573
NUDM,3899,0,0.00,0,0.00,29.52,3899,0
BAPR,3869,0,0.00,0,0.00,38.53,3869,0
JEMA,3839,0,0.00,0,0.00,35.48,3839,0
DIHP,3827,0,0.00,0,0.00,25.66,3255,572
PBUS,3811,0,0.00,0,0.00,49.55,3800,11
GSUS,3704,0,0.00,0,0.00,67.99,3625,79
MSFX,3614,0,0.00,0,0.00,26.13,3614,0
FOCT,3599,0,0.00,0,0.00,39.96,3599,0
ISPY,3502,0,0.00,0,0.00,40.00,3502,0
FYLD,3495,0,0.00,0,0.00,26.35,3495,0
AAPX,3466,0,0.00,0,0.00,18.74,3466,0
NUEM,3412,0,0.00,0,0.00,26.60,3412,0
BUFG,3387,0,0.00,0,0.00,21.83,3387,0
IETC,3355,0,0.00,0,0.00,65.50,3273,82
HEGD,3303,0,0.00,0,0.00,19.99,3303,0
PNOV,3303,0,0.00,0,0.00,35.21,3303,0
PJAN,3257,0,0.00,0,0.00,38.20,3257,0
YMAR,3223,0,0.00,0,0.00,22.56,3123,100
RSST,3213,0,0.00,0,0.00,22.48,3213,0
JPLD,3173,0,0.00,0,0.00,50.64,3173,0
PRNT,3162,0,0.00,0,0.00,20.83,3162,0
SMB,3061,0,0.00,0,0.00,16.97,3061,0
IMFL,3058,0,0.00,0,0.00,24.59,3058,0
OUSA,3035,0,0.00,0,0.00,46.89,2949,86
HYBL,2937,0,0.00,0,0.00,28.07,2774,163
SMOT,2935,0,0.00,0,0.00,31.39,2501,434
QLC,2913,0,0.00,0,0.00,55.69,2913,0
BBIN,2894,0,0.00,0,0.00,57.37,2894,0
CSM,2873,0,0.00,0,0.00,57.09,2773,100
OILK,2855,0,0.00,0,0.00,47.97,2855,0
FFSM,2854,0,0.00,0,0.00,24.33,2460,394
DDWM,2770,0,0.00,0,0.00,33.33,2770,0
IBMO,2739,0,0.00,0,0.00,25.23,2739,0
BBRE,2729,0,0.00,0,0.00,81.55,2650,79
NURE,2531,0,0.00,0,0.00,29.17,2531,0
FRDM,2505,0,0.00,0,0.00,32.03,2505,0
DDEC,2502,0,0.00,0,0.00,36.58,2502,0
REGL,2491,0,0.00,0,0.00,75.37,2491,0
FCLD,2465,0,0.00,0,0.00,22.86,2465,0
PAUG,2461,0,0.00,0,0.00,34.40,2461,0
IGLD,2452,0,0.00,0,0.00,20.23,2152,300
RSSB,2410,0,0.00,0,0.00,20.70,2410,0
ADFI,2400,0,0.00,0,0.00,8.37,2400,0
GHTA,2391,0,0.00,0,0.00,26.78,2391,0
TDV,2343,0,0.00,0,0.00,67.33,2343,0
NAPR,2285,0,0.00,0,0.00,43.80,2285,0
PFEB,2262,0,0.00,0,0.00,33.41,2262,0
XMPT,2256,0,0.00,0,0.00,20.83,2256,0
ZALT,2238,0,0.00,0,0.00,26.90,2238,0
POCT,2236,0,0.00,0,0.00,37.08,2036,200
GJAN,2223,0,0.00,0,0.00,35.14,2223,0
IBHF,2177,0,0.00,0,0.00,22.72,1777,400
FMAR,2147,0,0.00,0,0.00,37.90,2147,0
HCRB,2133,0,0.00,0,0.00,34.03,2133,0
BAMG,2125,0,0.00,0,0.00,28.30,125,2000
QVOY,2123,0,0.00,0,0.00,27.25,2123,0
FJUL,2121,0,0.00,0,0.00,43.09,2121,0
FDRV,2117,0,0.00,0,0.00,12.74,2117,0
ZECP,2111,0,0.00,0,0.00,26.81,1911,200
OGIG,2076,0,0.00,0,0.00,35.93,1876,200
XVV,2071,0,0.00,0,0.00,37.90,2071,0
DAUG,2067,0,0.00,0,0.00,36.44,2067,0
MVFD,2060,0,0.00,0,0.00,24.36,2060,0
PSEP,2058,0,0.00,0,0.00,35.76,2058,0
VTEC,2042,0,0.00,0,0.00,99.23,2042,0
JPIB,2036,0,0.00,0,0.00,46.87,2036,0
DUBS,2016,0,0.00,0,0.00,27.77,2016,0
QDTE,2005,0,0.00,0,0.00,44.09,2005,0
IBMP,2004,0,0.00,0,0.00,24.98,2004,0
ZIVB,1996,0,0.00,0,0.00,21.54,1996,0
MINN,1992,0,0.00,0,0.00,21.92,1992,0
GJUN,1976,0,0.00,0,0.00,32.83,1976,0
MEAR,1931,0,0.00,0,0.00,50.03,1931,0
XBAP,1925,0,0.00,0,0.00,30.23,1925,0
TMFG,1917,0,0.00,0,0.00,28.50,1917,0
APRD,1900,0,0.00,0,0.00,23.99,1900,0
EWUS,1900,0,0.00,0,0.00,33.34,1900,0
SHYD,1870,0,0.00,0,0.00,22.19,1870,0
DAPR,1849,0,0.00,0,0.00,33.43,1849,0
HYMU,1822,0,0.00,0,0.00,22.17,1822,0
VFVA,1801,0,0.00,0,0.00,112.39,1801,0
KOCT,1777,0,0.00,0,0.00,27.37,1777,0
XDTE,1768,0,0.00,0,0.00,50.04,1768,0
DSCF,1764,0,0.00,0,0.00,21.81,1764,0
EFUT,1764,0,0.00,0,0.00,25.23,1764,0
XSHQ,1760,0,0.00,0,0.00,39.06,1760,0
DUSA,1753,0,0.00,0,0.00,38.85,1753,0
VCEB,1741,0,0.00,0,0.00,60.95,1741,0
WFHY,1727,0,0.00,0,0.00,44.31,1727,0
IBHG,1680,0,0.00,0,0.00,21.84,1680,0
FDEC,1647,0,0.00,0,0.00,40.14,1647,0
GSEW,1630,0,0.00,0,0.00,68.73,1329,301
HYIN,1624,0,0.00,0,0.00,18.12,1624,0
IGRO,1547,0,0.00,0,0.00,64.61,1547,0
MSSS,1543,0,0.00,0,0.00,23.59,1543,0
PAWZ,1515,0,0.00,0,0.00,46.61,1515,0
BRLN,1471,0,0.00,0,0.00,52.26,1471,0
BUFB,1434,0,0.00,0,0.00,28.64,1434,0
JCPI,1423,0,0.00,0,0.00,46.10,1423,0
OMFS,1413,0,0.00,0,0.00,35.24,1413,0
AFIF,1391,0,0.00,0,0.00,9.03,1391,0
DWLD,1368,0,0.00,0,0.00,31.54,1368,0
SUPP,1334,0,0.00,0,0.00,61.44,1334,0
NETZ,1328,0,0.00,0,0.00,66.08,1328,0
FFEB,1327,0,0.00,0,0.00,43.82,1327,0
RTAI,1320,0,0.00,0,0.00,20.30,1320,0
RSBT,1312,0,0.00,0,0.00,17.89,1312,0
FCPI,1308,0,0.00,0,0.00,37.22,1307,1
VTEI,1303,0,0.00,0,0.00,99.16,1303,0
FBCV,1299,0,0.00,0,0.00,29.97,1299,0
AESR,1292,0,0.00,0,0.00,14.60,1292,0
QTJL,1291,0,0.00,0,0.00,28.70,1200,91
GDE,1290,0,0.00,0,0.00,32.08,1290,0
BFEB,1280,0,0.00,0,0.00,38.12,1280,0
FDVL,1266,0,0.00,0,0.00,11.21,1266,0
OEUR,1264,0,0.00,0,0.00,28.64,1264,0
ARKD,1259,0,0.00,0,0.00,40.54,1259,0
SATO,1230,0,0.00,0,0.00,12.17,1230,0
EDEN,1212,0,0.00,0,0.00,117.16,1212,0
STOT,1210,0,0.00,0,0.00,46.67,1210,0
FCTR,1186,0,0.00,0,0.00,29.73,1186,0
DINT,1185,0,0.00,0,0.00,18.76,1185,0
XJH,1176,0,0.00,0,0.00,38.18,1176,0
QPFF,1171,0,0.00,0,0.00,35.79,1171,0
TTAI,1149,0,0.00,0,0.00,28.66,1149,0
UOCT,1147,0,0.00,0,0.00,33.19,1147,0
TAIL,1138,0,0.00,0,0.00,12.05,1138,0
CAOS,1119,0,0.00,0,0.00,83.48,1119,0
IGHG,1119,0,0.00,0,0.00,76.46,1065,54
DJUL,1079,0,0.00,0,0.00,37.68,1079,0
GAA,1057,0,0.00,0,0.00,28.28,1057,0
ATMP,1055,0,0.00,0,0.00,23.94,1055,0
NOCT,1040,0,0.00,0,0.00,46.66,1040,0
ARKA,1031,0,0.00,0,0.00,61.78,1031,0
BAUG,1029,0,0.00,0,0.00,37.26,1029,0
BUSA,1014,0,0.00,0,0.00,29.51,1014,0
FLQS,1009,0,0.00,0,0.00,37.58,1009,0
BAMO,1007,0,0.00,0,0.00,27.40,1007,0
JULD,1000,0,0.00,0,0.00,24.99,1000,0
RPHS,985,0,0.00,0,0.00,9.25,985,0
PJUL,970,0,0.00,0,0.00,37.29,970,0
FMAY,963,0,0.00,0,0.00,42.93,963,0
INTL,940,0,0.00,0,0.00,21.97,940,0
IYLD,925,0,0.00,0,0.00,19.48,925,0
KAPR,907,0,0.00,0,0.00,29.69,907,0
FYEE,902,0,0.00,0,0.00,24.07,902,0
BAMB,901,0,0.00,0,0.00,25.40,901,0
NJUL,900,0,0.00,0,0.00,56.18,900,0
FNOV,888,0,0.00,0,0.00,43.63,888,0
GJUL,882,0,0.00,0,0.00,33.09,882,0
XJR,868,0,0.00,0,0.00,36.49,868,0
SEIM,841,0,0.00,0,0.00,29.68,841,0
BSEP,840,0,0.00,0,0.00,37.99,840,0
OCTQ,825,0,0.00,0,0.00,23.95,825,0
FFOG,813,0,0.00,0,0.00,31.46,813,0
FUNL,810,0,0.00,0,0.00,37.63,810,0
EFNL,802,0,0.00,0,0.00,35.02,802,0
QJUN,800,0,0.00,0,0.00,24.53,800,0
SNAV,788,0,0.00,0,0.00,27.79,788,0
MOHR,787,0,0.00,0,0.00,20.57,787,0
YJUN,786,0,0.00,0,0.00,21.22,786,0
FAUG,779,0,0.00,0,0.00,41.91,779,0
KJAN,774,0,0.00,0,0.00,33.74,774,0
IBHH,763,0,0.00,0,0.00,22.83,763,0
XFEB,761,0,0.00,0,0.00,29.98,761,0
PBP,756,0,0.00,0,0.00,21.90,756,0
KRUZ,748,0,0.00,0,0.00,28.70,748,0
SVAL,735,0,0.00,0,0.00,28.78,536,199
XDAT,735,0,0.00,0,0.00,21.11,735,0
ARKZ,721,0,0.00,0,0.00,37.18,721,0
EPRF,716,0,0.00,0,0.00,18.37,716,0
VEGN,713,0,0.00,0,0.00,43.21,423,290
TILT,710,0,0.00,0,0.00,186.41,710,0
INAV,693,0,0.00,0,0.00,25.11,693,0
ENOR,686,0,0.00,0,0.00,23.24,686,0
MSMR,680,0,0.00,0,0.00,26.73,680,0
NJAN,664,0,0.00,0,0.00,42.15,664,0
VFQY,662,0,0.00,0,0.00,128.15,662,0
IBHI,654,0,0.00,0,0.00,22.74,654,0
WEED,638,0,0.00,0,0.00,38.61,638,0
LQDW,637,0,0.00,0,0.00,28.23,637,0
SHAG,637,0,0.00,0,0.00,46.72,637,0
GFEB,636,0,0.00,0,0.00,33.54,636,0
GMOM,627,0,0.00,0,0.00,27.94,627,0
IZRL,618,0,0.00,0,0.00,18.81,618,0
MBCC,615,0,0.00,0,0.00,30.63,532,83
KWT,613,0,0.00,0,0.00,32.43,613,0
XBJA,613,0,0.00,0,0.00,26.40,613,0
BGLD,606,0,0.00,0,0.00,20.20,306,300
FJUN,604,0,0.00,0,0.00,45.72,604,0
IBMN,600,0,0.00,0,0.00,26.40,600,0
PMAY,600,0,0.00,0,0.00,32.52,600,0
VFMF,599,0,0.00,0,0.00,119.70,599,0
RDFI,597,0,0.00,0,0.00,22.36,597,0
PTEU,593,0,0.00,0,0.00,25.46,593,0
XDAP,589,0,0.00,0,0.00,30.28,589,0
DECZ,555,0,0.00,0,0.00,32.92,555,0
BINV,551,0,0.00,0,0.00,28.42,551,0
GNOV,547,0,0.00,0,0.00,32.51,547,0
GSEP,545,0,0.00,0,0.00,32.57,545,0
BUFT,520,0,0.00,0,0.00,21.08,520,0
QUVU,512,0,0.00,0,0.00,23.57,512,0
UJUN,512,0,0.00,0,0.00,30.90,512,0
FPRO,510,0,0.00,0,0.00,19.35,510,0
HSRT,502,0,0.00,0,0.00,39.07,502,0
SHDG,500,0,0.00,0,0.00,25.24,0,500
SMAY,500,0,0.00,0,0.00,21.88,500,0
USEP,500,0,0.00,0,0.00,32.20,500,0
BOCT,491,0,0.00,0,0.00,39.80,491,0
SELV,487,0,0.00,0,0.00,26.52,487,0
GTIP,463,0,0.00,0,0.00,48.15,463,0
LOCT,461,0,0.00,0,0.00,23.98,461,0
JANJ,454,0,0.00,0,0.00,24.65,454,0
BJUN,450,0,0.00,0,0.00,37.01,450,0
TMAT,446,0,0.00,0,0.00,15.56,446,0
AMZP,429,0,0.00,0,0.00,29.84,429,0
TGLR,423,0,0.00,0,0.00,25.70,423,0
IQM,421,0,0.00,0,0.00,52.77,421,0
BNOV,418,0,0.00,0,0.00,35.87,418,0
BDEC,400,0,0.00,0,0.00,39.71,400,0
ARKY,398,0,0.00,0,0.00,37.85,398,0
IBHJ,394,0,0.00,0,0.00,25.46,394,0
HOCT,393,0,0.00,0,0.00,24.09,393,0
FPFD,382,0,0.00,0,0.00,21.03,382,0
EAOR,377,0,0.00,0,0.00,29.01,377,0
HELX,363,0,0.00,0,0.00,29.43,363,0
TYLD,357,0,0.00,0,0.00,25.26,357,0
FLIA,349,0,0.00,0,0.00,20.02,349,0
GAUG,343,0,0.00,0,0.00,32.42,343,0
DFEB,342,0,0.00,0,0.00,38.02,342,0
XIMR,335,0,0.00,0,0.00,30.71,335,0
KJUL,333,0,0.00,0,0.00,26.57,333,0
DURA,328,0,0.00,0,0.00,31.28,328,0
PSMD,319,0,0.00,0,0.00,26.46,319,0
USMF,319,0,0.00,0,0.00,44.09,319,0
BLDG,318,0,0.00,0,0.00,23.35,218,100
VWID,317,0,0.00,0,0.00,26.31,317,0
VFMV,316,0,0.00,0,0.00,107.62,316,0
BJUL,314,0,0.00,0,0.00,38.93,314,0
UNOV,312,0,0.00,0,0.00,32.32,312,0
UDEC,305,0,0.00,0,0.00,32.79,305,0
UMAR,302,0,0.00,0,0.00,31.70,302,0
UJAN,300,0,0.00,0,0.00,35.25,300,0
FJAN,290,0,0.00,0,0.00,40.88,290,0
BALI,274,0,0.00,0,0.00,27.35,274,0
IAUF,271,0,0.00,0,0.00,62.79,271,0
SEIV,271,0,0.00,0,0.00,29.32,271,0
WUGI,268,0,0.00,0,0.00,56.29,268,0
PBTP,257,0,0.00,0,0.00,25.06,157,100
FRNW,256,0,0.00,0,0.00,13.83,256,0
SEIQ,247,0,0.00,0,0.00,30.49,247,0
QCON,243,0,0.00,0,0.00,41.20,243,0
XDEC,243,0,0.00,0,0.00,34.77,243,0
ESG,242,0,0.00,0,0.00,119.77,242,0
AAPY,235,0,0.00,0,0.00,23.00,235,0
BJAN,221,0,0.00,0,0.00,42.17,221,0
FSEP,217,0,0.00,0,0.00,41.45,217,0
TSLP,213,0,0.00,0,0.00,17.04,213,0
FBUF,212,0,0.00,0,0.00,24.30,212,0
FIBR,210,0,0.00,0,0.00,84.43,210,0
NULC,209,0,0.00,0,0.00,40.49,181,28
PBAP,204,0,0.00,0,0.00,24.50,204,0
FDEM,203,0,0.00,0,0.00,23.90,203,0
EAOA,202,0,0.00,0,0.00,32.37,202,0
AUGZ,200,0,0.00,0,0.00,35.03,200,0
BBLB,200,0,0.00,0,0.00,84.79,200,0
GVAL,200,0,0.00,0,0.00,21.14,200,0
IPPP,200,0,0.00,0,0.00,9.59,200,0
DMAY,198,0,0.00,0,0.00,37.24,198,0
GHEE,195,0,0.00,0,0.00,26.52,195,0
DALT,182,0,0.00,0,0.00,8.89,182,0
YDEC,181,0,0.00,0,0.00,22.86,181,0
TOKE,180,0,0.00,0,0.00,6.01,180,0
BUFZ,179,0,0.00,0,0.00,21.86,179,0
WDNA,177,0,0.00,0,0.00,15.00,177,0
TJUL,176,0,0.00,0,0.00,25.95,176,0
UJUL,176,0,0.00,0,0.00,31.31,176,0
APRJ,171,0,0.00,0,0.00,24.36,171,0
FDEV,170,0,0.00,0,0.00,26.24,170,0
IVVW,169,0,0.00,0,0.00,48.14,164,5
XJAN,167,0,0.00,0,0.00,31.31,167,0
FDHT,166,0,0.00,0,0.00,17.92,166,0
MAMB,165,0,0.00,0,0.00,21.76,165,0
XSEP,163,0,0.00,0,0.00,36.70,163,0
GHYG,159,0,0.00,0,0.00,43.13,159,0
PEX,159,0,0.00,0,0.00,29.00,159,0
PSFD,156,0,0.00,0,0.00,29.72,156,0
EFAD,150,0,0.00,0,0.00,37.05,150,0
GDMN,150,0,0.00,0,0.00,29.17,150,0
FFLV,149,0,0.00,0,0.00,20.34,149,0
LEAD,145,0,0.00,0,0.00,61.41,145,0
GOCT,144,0,0.00,0,0.00,33.08,144,0
HYXU,144,0,0.00,0,0.00,47.72,144,0
BSMC,141,0,0.00,0,0.00,28.23,141,0
GLOV,133,0,0.00,0,0.00,44.87,133,0
BCHP,131,0,0.00,0,0.00,29.84,131,0
NXTV,129,0,0.00,0,0.00,24.94,129,0
LKOR,122,0,0.00,0,0.00,41.80,122,0
MAGA,121,0,0.00,0,0.00,43.92,121,0
MSFY,118,0,0.00,0,0.00,27.05,118,0
DFND,115,0,0.00,0,0.00,38.07,115,0
BMAY,114,0,0.00,0,0.00,35.39,114,0
EUDV,114,0,0.00,0,0.00,46.50,114,0
ISVL,111,0,0.00,0,0.00,34.15,110,1
BAMU,110,0,0.00,0,0.00,25.34,110,0
DNOV,109,0,0.00,0,0.00,39.60,109,0
DOGG,107,0,0.00,0,0.00,20.33,107,0
MPRO,107,0,0.00,0,0.00,26.82,107,0
IVRA,105,0,0.00,0,0.00,13.41,105,0
TMDV,102,0,0.00,0,0.00,46.08,102,0
MYLD,101,0,0.00,0,0.00,25.49,101,0
DSEP,100,0,0.00,0,0.00,37.41,100,0
GSID,100,0,0.00,0,0.00,54.22,100,0
KNOW,100,0,0.00,0,0.00,10.13,100,0
LQDI,100,0,0.00,0,0.00,25.48,100,0
NUDV,100,0,0.00,0,0.00,25.83,100,0
OCTH,100,0,0.00,0,0.00,24.12,100,0
PSMR,100,0,0.00,0,0.00,24.77,100,0
QTOC,100,0,0.00,0,0.00,26.22,100,0
XJUN,100,0,0.00,0,0.00,36.07,100,0
XOCT,100,0,0.00,0,0.00,32.66,100,0
XTOC,100,0,0.00,0,0.00,27.46,100,0
XVOL,100,0,0.00,0,0.00,19.50,100,0
VAMO,79,0,0.00,0,0.00,28.62,79,0
BMAR,78,0,0.00,0,0.00,40.12,78,0
MARZ,78,0,0.00,0,0.00,28.85,78,0
GDEC,74,0,0.00,0,0.00,30.97,74,0
UMAY,73,0,0.00,0,0.00,30.32,73,0
TFJL,70,0,0.00,0,0.00,19.63,70,0
ADME,58,0,0.00,0,0.00,40.02,58,0
EMTL,58,0,0.00,0,0.00,41.75,58,0
NOVZ,56,0,0.00,0,0.00,36.12,56,0
HAUS,55,0,0.00,0,0.00,16.34,55,0
EVUS,54,0,0.00,0,0.00,26.42,54,0
ROMO,54,0,0.00,0,0.00,27.47,54,0
JULH,53,0,0.00,0,0.00,24.95,53,0
SNPG,52,0,0.00,0,0.00,35.95,52,0
GDMA,49,0,0.00,0,0.00,30.23,49,0
SAUG,49,0,0.00,0,0.00,20.90,49,0
XUSP,47,0,0.00,0,0.00,32.47,47,0
BAMY,45,0,0.00,0,0.00,25.96,39,6
DJAN,45,0,0.00,0,0.00,35.16,45,0
YSEP,40,0,0.00,0,0.00,20.76,40,0
TTAC,38,0,0.00,0,0.00,57.05,38,0
BBEM,36,0,0.00,0,0.00,48.94,36,0
GEMD,36,0,0.00,0,0.00,39.83,36,0
GOOP,33,0,0.00,0,0.00,28.20,33,0
JANQ,27,0,0.00,0,0.00,24.56,27,0
APRH,26,0,0.00,0,0.00,24.18,26,0
MSTB,23,0,0.00,0,0.00,30.15,23,0
GPOW,22,0,0.00,0,0.00,42.98,22,0
QTJA,22,0,0.00,0,0.00,21.60,22,0
FDND,20,0,0.00,0,0.00,19.24,20,0
FEBP,20,0,0.00,0,0.00,25.40,20,0
IWMW,18,0,0.00,0,0.00,46.85,17,1
APRQ,17,0,0.00,0,0.00,24.44,17,0
ESGG,17,0,0.00,0,0.00,154.49,17,0
DWAT,16,0,0.00,0,0.00,10.27,16,0
FLDZ,14,0,0.00,0,0.00,24.89,14,0
XDSQ,14,0,0.00,0,0.00,29.54,14,0
WFIG,13,0,0.00,0,0.00,43.30,13,0
UFEB,12,0,0.00,0,0.00,30.12,12,0
BLKC,11,0,0.00,0,0.00,18.09,11,0
HYHG,11,0,0.00,0,0.00,63.67,11,0
RVRB,11,0,0.00,0,0.00,25.89,11,0
HIYS,10,0,0.00,0,0.00,25.15,10,0
NXTI,10,0,0.00,0,0.00,25.01,10,0
XISE,10,0,0.00,0,0.00,30.45,10,0
XJUL,10,0,0.00,0,0.00,33.04,10,0
AJAN,9,0,0.00,0,0.00,24.53,9,0
BBIB,7,0,0.00,0,0.00,94.97,7,0
FAIL,7,0,0.00,0,0.00,16.86,7,0
TYA,7,0,0.00,0,0.00,12.38,7,0
EAOM,6,0,0.00,0,0.00,25.91,6,0
MVAL,6,0,0.00,0,0.00,29.13,6,0
GOLY,5,0,0.00,0,0.00,22.48,5,0
HFGO,5,0,0.00,0,0.00,18.47,5,0
XBOC,5,0,0.00,0,0.00,28.48,5,0
BKGI,4,0,0.00,0,0.00,27.92,4,0
ARKC,3,0,0.00,0,0.00,40.08,3,0
BAMV,3,0,0.00,0,0.00,29.03,3,0
MOTG,3,0,0.00,0,0.00,34.45,3,0
ROYA,3,0,0.00,0,0.00,26.15,3,0
TRTY,3,0,0.00,0,0.00,25.38,3,0
TUSI,3,0,0.00,0,0.00,25.26,3,0
WBAT,3,0,0.00,0,0.00,27.14,3,0
BBSA,2,0,0.00,0,0.00,47.01,2,0
HEAT,2,0,0.00,0,0.00,24.00,2,0
PSMO,2,0,0.00,0,0.00,25.86,2,0
SNPD,2,0,0.00,0,0.00,25.58,2,0
TDVI,2,0,0.00,0,0.00,21.28,2,0
BEMB,1,0,0.00,0,0.00,51.18,1,0
BWTG,1,0,0.00,0,0.00,29.76,1,0
CMCI,1,0,0.00,0,0.00,25.94,1,0
IPDP,1,0,0.00,0,0.00,17.31,1,0
IVVB,1,0,0.00,0,0.00,26.70,1,0
JANZ,1,0,0.00,0,0.00,30.84,1,0
JULJ,1,0,0.00,0,0.00,24.94,1,0
JULQ,1,0,0.00,0,0.00,24.90,1,0
LJAN,1,0,0.00,0,0.00,24.55,1,0
MSTQ,1,0,0.00,0,0.00,29.18,1,0
OCTD,1,0,0.00,0,0.00,24.26,1,0
PWS,1,0,0.00,0,0.00,27.64,1,0
TOLL,1,0,0.00,0,0.00,29.67,1,0
ACSI,0,0,0.00,0,0.00,0.00,0,0
APRP,0,0,0.00,0,0.00,0.00,0,0
APRZ,0,0,0.00,0,0.00,0.00,0,0
ARCM,0,0,0.00,0,0.00,0.00,0,0
ARLU,0,0,0.00,0,0.00,0.00,0,0
BAMA,0,0,0.00,0,0.00,0.00,0,0
BBIP,0,0,0.00,0,0.00,0.00,0,0
BBSB,0,0,0.00,0,0.00,0.00,0,0
BHYB,0,0,0.00,0,0.00,0.00,0,0
BUYZ,0,0,0.00,0,0.00,0.00,0,0
CFCV,0,0,0.00,0,0.00,0.00,0,0
CVAR,0,0,0.00,0,0.00,0.00,0,0
DFHY,0,0,0.00,0,0.00,0.00,0,0
DFNV,0,0,0.00,0,0.00,0.00,0,0
DFRA,0,0,0.00,0,0.00,0.00,0,0
DJUN,0,0,0.00,0,0.00,0.00,0,0
DWCR,0,0,0.00,0,0.00,0.00,0,0
EAOK,0,0,0.00,0,0.00,0.00,0,0
EGUS,0,0,0.00,0,0.00,0.00,0,0
EMDV,0,0,0.00,0,0.00,0.00,0,0
FDCE,0,0,0.00,0,0.00,0.00,0,0
FDGR,0,0,0.00,0,0.00,0.00,0,0
FDTB,0,0,0.00,0,0.00,0.00,0,0
FEBZ,0,0,0.00,0,0.00,0.00,0,0
FHEQ,0,0,0.00,0,0.00,0.00,0,0
FPAG,0,0,0.00,0,0.00,0.00,0,0
GCLN,0,0,0.00,0,0.00,0.00,0,0
GHMS,0,0,0.00,0,0.00,0.00,0,0
GMAY,0,0,0.00,0,0.00,0.00,0,0
GSEE,0,0,0.00,0,0.00,0.00,0,0
HAPR,0,0,0.00,0,0.00,0.00,0,0
HJAN,0,0,0.00,0,0.00,0.00,0,0
HSUN,0,0,0.00,0,0.00,0.00,0,0
HYKE,0,0,0.00,0,0.00,0.00,0,0
IMSI,0,0,0.00,0,0.00,0.00,0,0
IVVM,0,0,0.00,0,0.00,0.00,0,0
JAND,0,0,0.00,0,0.00,0.00,0,0
JANH,0,0,0.00,0,0.00,0.00,0,0
JANP,0,0,0.00,0,0.00,0.00,0,0
JULZ,0,0,0.00,0,0.00,0.00,0,0
JUNZ,0,0,0.00,0,0.00,0.00,0,0
LAPR,0,0,0.00,0,0.00,0.00,0,0
LBO,0,0,0.00,0,0.00,0.00,0,0
LCF,0,0,0.00,0,0.00,0.00,0,0
MAYZ,0,0,0.00,0,0.00,0.00,0,0
MBBB,0,0,0.00,0,0.00,0.00,0,0
MBND,0,0,0.00,0,0.00,0.00,0,0
MBNE,0,0,0.00,0,0.00,0.00,0,0
MDEV,0,0,0.00,0,0.00,0.00,0,0
MDLV,0,0,0.00,0,0.00,0.00,0,0
MDPL,0,0,0.00,0,0.00,0.00,0,0
MGRO,0,0,0.00,0,0.00,0.00,0,0
MIG,0,0,0.00,0,0.00,0.00,0,0
MOTE,0,0,0.00,0,0.00,0.00,0,0
MRCP,0,0,0.00,0,0.00,0.00,0,0
MRGR,0,0,0.00,0,0.00,0.00,0,0
MSVX,0,0,0.00,0,0.00,0.00,0,0
MVFG,0,0,0.00,0,0.00,0.00,0,0
OBND,0,0,0.00,0,0.00,0.00,0,0
OCTJ,0,0,0.00,0,0.00,0.00,0,0
OCTZ,0,0,0.00,0,0.00,0.00,0,0
PBFB,0,0,0.00,0,0.00,0.00,0,0
PBJA,0,0,0.00,0,0.00,0.00,0,0
PBL,0,0,0.00,0,0.00,0.00,0,0
PBMR,0,0,0.00,0,0.00,0.00,0,0
PIT,0,0,0.00,0,0.00,0.00,0,0
PJBF,0,0,0.00,0,0.00,0.00,0,0
PJFM,0,0,0.00,0,0.00,0.00,0,0
PSCJ,0,0,0.00,0,0.00,0.00,0,0
PSCQ,0,0,0.00,0,0.00,0.00,0,0
PSCW,0,0,0.00,0,0.00,0.00,0,0
PSCX,0,0,0.00,0,0.00,0.00,0,0
PSDM,0,0,0.00,0,0.00,0.00,0,0
PSFJ,0,0,0.00,0,0.00,0.00,0,0
PSFM,0,0,0.00,0,0.00,0.00,0,0
PSFO,0,0,0.00,0,0.00,0.00,0,0
PSH,0,0,0.00,0,0.00,0.00,0,0
PSMJ,0,0,0.00,0,0.00,0.00,0,0
PUTD,0,0,0.00,0,0.00,0.00,0,0
QTAP,0,0,0.00,0,0.00,0.00,0,0
RMIF,0,0,0.00,0,0.00,0.00,0,0
RODE,0,0,0.00,0,0.00,0.00,0,0
ROIS,0,0,0.00,0,0.00,0.00,0,0
RYSE,0,0,0.00,0,0.00,0.00,0,0
SCLZ,0,0,0.00,0,0.00,0.00,0,0
SEPZ,0,0,0.00,0,0.00,0.00,0,0
SFIG,0,0,0.00,0,0.00,0.00,0,0
SMI,0,0,0.00,0,0.00,0.00,0,0
SNOV,0,0,0.00,0,0.00,0.00,0,0
SNPV,0,0,0.00,0,0.00,0.00,0,0
SPCZ,0,0,0.00,0,0.00,0.00,0,0
SPMV,0,0,0.00,0,0.00,0.00,0,0
STBF,0,0,0.00,0,0.00,0.00,0,0
TBJL,0,0,0.00,0,0.00,0.00,0,0
TSLH,0,0,0.00,0,0.00,0.00,0,0
VHAI+A,0,0,0.00,0,0.00,0.00,0,0
VHAI+B,0,0,0.00,0,0.00,0.00,0,0
VIRS,0,0,0.00,0,0.00,0.00,0,0
VMAX,0,0,0.00,0,0.00,0.00,0,0
WLDR,0,0,0.00,0,0.00,0.00,0,0
XAUG,0,0,0.00,0,0.00,0.00,0,0
XBJL,0,0,0.00,0,0.00,0.00,0,0
XDJA,0,0,0.00,0,0.00,0.00,0,0
XDJL,0,0,0.00,0,0.00,0.00,0,0
XDOC,0,0,0.00,0,0.00,0.00,0,0
XDQQ,0,0,0.00,0,0.00,0.00,0,0
XEMD,0,0,0.00,0,0.00,0.00,0,0
XIDE,0,0,0.00,0,0.00,0.00,0,0
XNOV,0,0,0.00,0,0.00,0.00,0,0
XTAP,0,0,0.00,0,0.00,0.00,0,0
XTJA,0,0,0.00,0,0.00,0.00,0,0
XTJL,0,0,0.00,0,0.00,0.00,0,0